TTTTTTTTTT
TTTTTTTTTT
TTTTTTTTTT
TTTTPTWTTT
TWWWWWWTTT
TTTTTGWTTT
TTTTTWWTTT
TTTTTTTTTT
TTTTTTTTTT
TTTTTTTTTT